Speed to the end using quick apples!
......................................................
......................................................
.............................................X........
............................................---.......
......................................z...............
.....................................---..............
...............................z......................
...............................---....................
......................z....z..........................
...................---------..........................
.............z........................................
..........-----.......................................
......................................................
.1...z................................................
######################################################